111111111
1C00000X1
10P0E0001
1X0C000C1
1C00000C1
111111111
