1111111111111111111
1P00000000C000C0011
100001X011000011001
100001000X000000001
1C0001100X000001111
111011111000001C001
10000C0000001111E01
1000110000000010001
100000X001111000001
1111111111111111111
