11111111111111111
1P00000000C000001
1C001X00000110011
101000011X0000001
1X001000000C01101
111001110000000C1
1C0000X0011100001
10011110001110001
1000000000C001001
1X00E0001000X0001
10111110000111001
11111111111111111
