111111111111111
1P000000C000001
101111111101001
1X0000010000C01
100C01001111111
111001000000E01
100C01000011101
1000111100X0001
1C00000X0000011
1C0X01110001111
100001000C00001
1C0001000000001
111111111111111
