1111111111111111
1P00000100000001
1C11101111000101
10000001000000C1
1000011100111011
1C0X00X000000001
1011111000111011
1C00001000X00001
1E00111001111001
1000000000000C01
1111111111111111
