111111111111111111
1P00000C0000010001
101111011100111001
1X0010000000000001
100C001X0001111101
100111111011100E01
1000000C001X000001
101111001110111101
1X0000000010000001
100000000C00100101
101110111000100001
111111111111111111
