1111111111111111
1P000000C0000001
1011111111101001
1C001000000X0001
1X01110000101111
10000C1000100E01
100111000X000001
101000X011000011
1000000010000001
1X01110001100101
1C0000C000010001
100000X000011001
1111111111111111
