1111111111111111111
1P000000000C0000001
1011111110001110001
1X00C000X0000011001
1C001000100000X0011
1000111100111100011
1X0000C001000001111
101110X011001100001
1C00110000000000101
1E00X001111100000C1
10001100000C0000111
1111111111111111111
