111111111111111111
1P0000000000C00001
101100001111101001
1X000C00000000X001
111111110011100101
100X00000000000111
10C111000011110E01
1X000C000X00000001
111110111011100001
1C0010000000000011
100001X00011110001
1C0001000C000X0001
1000000011000010C1
111111111111111111
