11111111111111111
100000C0000E11111
1XC111101011110X1
1000XP001C0000001
1C1011000000X0001
101011011011110X1
1X0000C00011110C1
11111111111111111
