11111111111111111111111
1E00000000X0C1000000001
100101101000010111XC001
1001000010110001C1000C1
1P000X100X00000X000X001
1001101C1C11000101000C1
11111111111111111111111
