11111111111111111
1P00000C000001001
10111101110011101
1X001000000000001
100C001X000111111
100111111011100E1
1000000C001X00001
10111100111011111
1X000000001000001
100000000C0010011
101110111000100C1
11111111111111111
