1111111111111111
1P00001000C00001
1110111100111001
1X0000000100X001
100C011100011101
100001000C100001
1110011111010001
100X000010000001
1011111000011001
1C00X000001C00E1
1000001000000001
1111111111111111
