111111111
1C00000X1
10PE00001
1X0C000C1
1C000A0C1
111111111
