11111111111111111111111
1100000C000000000E11111
11011111111111111111011
11C0000P1111C1110011111
11110110000001000111111
11110111111111011110011
111100000C0000011110001
11111111111111111111111